9.ox
.ooo......
.o........
oooo..o...
........o.
.o..o.....
o.........
..o.....o.
....ooo.o.
oo.......o
